Test that several different grid items along with several minmax tracks are properly sized.

XXXXX XXXXX
XXXXX XXXXX XXXXX
XXXXX XXXXX XXXXX XXXXX
XXXXX XXXXX
PASS
XXXXX XXXXX
XXXXX XXXXX XXXXX
XXXXX XXXXX
XXXXX XXXXX XXXXX XXXXX
PASS
XXXXX XXXXX
XXXXX XXXXX XXXXX
XXXXX XXXXX
XXXXX XXXXX XXXXX XXXXX
PASS
XXXXX XXXXX
XXXXX XXXXX XXXXX
XXXXX XXXXX
XXXXX XXXXX XXXXX XXXXX
PASS
