Test that grid items with a percentage logical height inside a grid without explicit sizes resolve their size properly.

XXXXX XXXXXX
XXXXX XXXXXX
XXXXX XXXXXX
XXXXX XXXXXX
PASS
XXXXX XXXXXX
XXXXX XXXXXX
XXXXX XXXXXX
XXXXX XXXXXX
PASS
XXXXX XXXXXX
XXXXX XXXXXX
XXXXX XXXXXX
XXXXX XXXXXX
PASS
XXXXX XXXXXX
XXXXX XXXXX XXXXXX
XXXXX XXXXXX
XXXXX XXXXX XXXXX XXXXXX
PASS
XXXXX XXXXXX
XXXXX XXXXXX
XXXXX XXXXXX
XXXXX XXXXXX
PASS
XXXXX XXXXXX
XXXXX XXXXXX
XXXXX XXXXXX
XXXXX XXXXXX
PASS
XXXXX XXXXXX
XXXXX XXXXXX
XXXXX XXXXXX
XXXXX XXXXXX
PASS
XXXXX XXXXXX
XXXXX XXXXX XXXXXX
XXXXX XXXXXX
XXXXX XXXXX XXXXX XXXXXX
PASS
XXXXX XXXXXX
XXXXX XXXXXX
XXXXX XXXXXX
XXXXX XXXXXX
PASS
XXXXX XXXXXX
XXXXX XXXXXX
XXXXX XXXXXX
XXXXX XXXXXX
PASS
XXXXX XXXXXX
XXXXX XXXXXX
XXXXX XXXXXX
XXXXX XXXXXX
PASS
XXXXX XXXXXX
XXXXX XXXXX XXXXXX
XXXXX XXXXXX
XXXXX XXXXX XXXXX XXXXXX
PASS
