Test that resolving minmax function with min-content on grid items works properly.

XXX XXX
PASS
XXX XXX
PASS
XXX XXX XXX XXX
PASS
XX XX XX XX XX XX
PASS
XX XX XX XX XX XX
PASS
XXX XXX
PASS
XX XX XX XX XX XX
PASS
XX XX XX XX XX XX
PASS
XXX XXX
PASS
XXX XXX XXX
PASS
XX XX XX XX XX XX
PASS
XXX XXX
PASS
